CATCATCC	FASTA/wells/randO_well_1
CTGCTTTG	FASTA/wells/randO_well_2
CTAAGGGA	FASTA/wells/randO_well_3
GCTTATAG	FASTA/wells/randO_well_4
TCTGATCC	FASTA/wells/randO_well_5
TCTCTTGG	FASTA/wells/randO_well_6
CAATTTCC	FASTA/wells/randO_well_7
AGTCTCTT	FASTA/wells/randO_well_8
TGCTGCTC	FASTA/wells/randO_well_9
GTATTTCC	FASTA/wells/randO_well_10
TTCCTGTG	FASTA/wells/randO_well_11
GCTGCTTC	FASTA/wells/randO_well_12
TATGTGTC	FASTA/wells/randO_well_13
CAATTCTC	FASTA/wells/randO_well_14
TGGTCTCC	FASTA/wells/randO_well_15
GCTCTTTA	FASTA/wells/randO_well_16
GCTGCATG	FASTA/wells/randO_well_17
ACTCATTT	FASTA/wells/randO_well_18
AGTCTTGG	FASTA/wells/randO_well_19
GGTTCTTC	FASTA/wells/randO_well_20
TCATGTTG	FASTA/wells/randO_well_21
ATTTTGCC	FASTA/wells/randO_well_22
CTTCTGTA	FASTA/wells/randO_well_23
GTCCATCT	FASTA/wells/randO_well_24
GCTATCTC	FASTA/wells/randO_well_25
TAGTTTCC	FASTA/wells/randO_well_26
TCCATTAT	FASTA/wells/randO_well_27
AGGATTAA	FASTA/wells/randO_well_28
AATCTTTC	FASTA/wells/randO_well_29
GTCATATG	FASTA/wells/randO_well_30
GTGCTTCC	FASTA/wells/randO_well_31
ATGTGTTG	FASTA/wells/randO_well_32
CCATCTTG	FASTA/wells/randO_well_33
TACTGTCT	FASTA/wells/randO_well_34
TTCATCGC	FASTA/wells/randO_well_35
ACTGTGGG	FASTA/wells/randO_well_36
TCTGTGCC	FASTA/wells/randO_well_37
TCAATCTC	FASTA/wells/randO_well_38
GTCCTCTG	FASTA/wells/randO_well_39
TTACATTC	FASTA/wells/randO_well_40
ATTCTGTC	FASTA/wells/randO_well_41
TGTGTATG	FASTA/wells/randO_well_42
TCCATTTG	FASTA/wells/randO_well_43
TTAGCTTC	FASTA/wells/randO_well_44
GTGCTTGA	FASTA/wells/randO_well_45
GTTTGTGA	FASTA/wells/randO_well_46
GAAATTAG	FASTA/wells/randO_well_47
GCAAATTC	FASTA/wells/randO_well_48
GAGGTTGA	FASTA/wells/randO_well_49
CCTGTCTG	FASTA/wells/randO_well_50
GTGGGTTC	FASTA/wells/randO_well_51
TTTGCATC	FASTA/wells/randO_well_52
AGGTAATA	FASTA/wells/randO_well_53
GTGCCTTC	FASTA/wells/randO_well_54
ATGTTTCC	FASTA/wells/randO_well_55
CTTAATTC	FASTA/wells/randO_well_56
TCTGGCTC	FASTA/wells/randO_well_57
CATCATTT	FASTA/wells/randO_well_58
GTTGTCTC	FASTA/wells/randO_well_59
ATCTTCTG	FASTA/wells/randO_well_60
TGTTTGCC	FASTA/wells/randO_well_61
TTCTGTCA	FASTA/wells/randO_well_62
ACGGACTC	FASTA/wells/randO_well_63
TTTGGTCA	FASTA/wells/randO_well_64
TATCCGGG	FASTA/wells/randO_well_65
TGTCATTC	FASTA/wells/randO_well_66
ATTCTCTG	FASTA/wells/randO_well_67
TGGCTTCC	FASTA/wells/randO_well_68
TTGTTGCC	FASTA/wells/randO_well_69
GTCATCTC	FASTA/wells/randO_well_70
TTGCTCAT	FASTA/wells/randO_well_71
CTGTCTGC	FASTA/wells/randO_well_72
TATATTCC	FASTA/wells/randO_well_73
ATATTGGC	FASTA/wells/randO_well_74
GTGTCCTC	FASTA/wells/randO_well_75
ATCTTCAT	FASTA/wells/randO_well_76
CGTGGTTG	FASTA/wells/randO_well_77
TTGCATCC	FASTA/wells/randO_well_78
TCTTAATC	FASTA/wells/randO_well_79
TGCATTTC	FASTA/wells/randO_well_80
GATGTTTC	FASTA/wells/randO_well_81
ATCTTGTC	FASTA/wells/randO_well_82
TCATATTC	FASTA/wells/randO_well_83
TGGCCTCT	FASTA/wells/randO_well_84
CGTTGTCT	FASTA/wells/randO_well_85
TCTTGTCA	FASTA/wells/randO_well_86
TATTCCTG	FASTA/wells/randO_well_87
TCCATGTC	FASTA/wells/randO_well_88
TTGTCATC	FASTA/wells/randO_well_89
ATTTCCTG	FASTA/wells/randO_well_90
GTGTCTCC	FASTA/wells/randO_well_91
GTGTGTGT	FASTA/wells/randO_well_92
TATGCTTC	FASTA/wells/randO_well_93
ATGGTGTT	FASTA/wells/randO_well_94
GAATAATG	FASTA/wells/randO_well_95
CCTCTGTG	FASTA/wells/randO_well_96
CATTCCTA	FASTA/wells/polyT_well_1
CTTCATCA	FASTA/wells/polyT_well_2
CCTATATC	FASTA/wells/polyT_well_3
ACATTTAC	FASTA/wells/polyT_well_4
ACTTAGCT	FASTA/wells/polyT_well_5
CCAATTCT	FASTA/wells/polyT_well_6
GCCTATCT	FASTA/wells/polyT_well_7
ATGCTGCT	FASTA/wells/polyT_well_8
CATTTACA	FASTA/wells/polyT_well_9
ACTCGTAA	FASTA/wells/polyT_well_10
CCTTTGCA	FASTA/wells/polyT_well_11
ACTCCTGC	FASTA/wells/polyT_well_12
ATTTGGCA	FASTA/wells/polyT_well_13
TTATTCTG	FASTA/wells/polyT_well_14
TCATGCTC	FASTA/wells/polyT_well_15
CATACTTC	FASTA/wells/polyT_well_16
CCGTTCTA	FASTA/wells/polyT_well_17
GCTTCATA	FASTA/wells/polyT_well_18
CTCTGTGC	FASTA/wells/polyT_well_19
CCCTTATA	FASTA/wells/polyT_well_20
ACTGCTCT	FASTA/wells/polyT_well_21
CTCTAATC	FASTA/wells/polyT_well_22
ACCCTTGC	FASTA/wells/polyT_well_23
ATCTTAGG	FASTA/wells/polyT_well_24
CATGTCTC	FASTA/wells/polyT_well_25
TCATTGCA	FASTA/wells/polyT_well_26
ACACCTTT	FASTA/wells/polyT_well_27
AATTTCTC	FASTA/wells/polyT_well_28
ATTCATGG	FASTA/wells/polyT_well_29
ACTTTACC	FASTA/wells/polyT_well_30
CTTCTAAC	FASTA/wells/polyT_well_31
CTATTTCA	FASTA/wells/polyT_well_32
TCTCATGC	FASTA/wells/polyT_well_33
ATCCTTAC	FASTA/wells/polyT_well_34
TAAATATC	FASTA/wells/polyT_well_35
TTACCTGC	FASTA/wells/polyT_well_36
CACTTTCA	FASTA/wells/polyT_well_37
CACCTTTA	FASTA/wells/polyT_well_38
CTGACTTC	FASTA/wells/polyT_well_39
CATTTGGA	FASTA/wells/polyT_well_40
GCTCTACT	FASTA/wells/polyT_well_41
GTTACGTA	FASTA/wells/polyT_well_42
CCTGTTGC	FASTA/wells/polyT_well_43
CTATCATC	FASTA/wells/polyT_well_44
GCTATCAT	FASTA/wells/polyT_well_45
ACATTCAT	FASTA/wells/polyT_well_46
TTCGCTAC	FASTA/wells/polyT_well_47
CATTCTAC	FASTA/wells/polyT_well_48
CACTTATC	FASTA/wells/polyT_well_49
ATAAGCTC	FASTA/wells/polyT_well_50
TCATCCTG	FASTA/wells/polyT_well_51
CCTGGTAT	FASTA/wells/polyT_well_52
TGGTATAC	FASTA/wells/polyT_well_53
TTGGGAGA	FASTA/wells/polyT_well_54
ACTTCATC	FASTA/wells/polyT_well_55
TCTCTAGC	FASTA/wells/polyT_well_56
ATGCCCTT	FASTA/wells/polyT_well_57
CCCAATTT	FASTA/wells/polyT_well_58
ACTATATA	FASTA/wells/polyT_well_59
CTCTATAC	FASTA/wells/polyT_well_60
CTGTCTCA	FASTA/wells/polyT_well_61
GACCTTTC	FASTA/wells/polyT_well_62
GATTTGGC	FASTA/wells/polyT_well_63
CGTCTAGG	FASTA/wells/polyT_well_64
TACTCGAA	FASTA/wells/polyT_well_65
CAGCCTTT	FASTA/wells/polyT_well_66
CCTCATTA	FASTA/wells/polyT_well_67
CTTATACC	FASTA/wells/polyT_well_68
TCTATTAC	FASTA/wells/polyT_well_69
CCTGCATT	FASTA/wells/polyT_well_70
CAATCCTT	FASTA/wells/polyT_well_71
TTGTCTTA	FASTA/wells/polyT_well_72
TCACTTTA	FASTA/wells/polyT_well_73
TGCTTGGG	FASTA/wells/polyT_well_74
CGCTCATT	FASTA/wells/polyT_well_75
GCCTCTAT	FASTA/wells/polyT_well_76
GAGCACAA	FASTA/wells/polyT_well_77
CTCTTAAC	FASTA/wells/polyT_well_78
TCTAGGCT	FASTA/wells/polyT_well_79
AATTCTGC	FASTA/wells/polyT_well_80
CATTCTCA	FASTA/wells/polyT_well_81
ACTTGCCT	FASTA/wells/polyT_well_82
ATCATTGC	FASTA/wells/polyT_well_83
GTTCAACA	FASTA/wells/polyT_well_84
CCATTTGC	FASTA/wells/polyT_well_85
GACTTTGC	FASTA/wells/polyT_well_86
ATTGGCTC	FASTA/wells/polyT_well_87
GTGCTAGC	FASTA/wells/polyT_well_88
CTTTCAAC	FASTA/wells/polyT_well_89
ACTATTGC	FASTA/wells/polyT_well_90
ACTGGCTT	FASTA/wells/polyT_well_91
ATTAGGCT	FASTA/wells/polyT_well_92
GCCTTTCA	FASTA/wells/polyT_well_93
ATTCTAGG	FASTA/wells/polyT_well_94
CCTTACAT	FASTA/wells/polyT_well_95
ACATTTGG	FASTA/wells/polyT_well_96
